########
# .    #
# $$   #
# $ $@.#
# ..   #
########
