######
#    #
# @$.#
#    #
######
