###########
#  #####  #
#@   $   .#
#  #####  #
###########
