###########
#  #####  #
#@$      .#
#  #####  ####
#            #
#  #### #### #
#            #
##############
#            #
#            #
#            #
##############
