#############
#@       ...#
# $ $ $  ####
# $ $ $  ...#
#       #####
#########
