###########
#  #####  #
#@$      .#
#  #####  ####
#   ####### . #
# $ $      .. #
#  $#######   #
#   #####  ###
#  $   $ ..###
#   #####  ###
##############
