#####
# $.#
# $.#
# @ #
#####
