  ###########
 ##     #   #
### $ $$    #
# ##$    $$ #
#  #    #@  #
###### ######
##        ###
## ### ## ###
## ### ## ###
## ### ##  ##
## ### ### ##
##  ## ### ##
### ## ######
### ## ######
######    ###
#   ## ## ###
###    ## ###
### ## ######
### ## ######
##  ## ######
###### ######
#.. ..  #*##
# ..    ###
#  ..#####
#########
