    #####
    #@  #
    #   #
  ###   ##
  #      #
### # ## #   ######
#   # ## #####  ..#
#              $..#
##### ### # ##  ..#
    #     #########
    #######
