################################################
#@  #####################################    ###
# .                                       ## ###
## ###################################### ## ###
## #          . . . . . . . . . .        . # ###
## #                                       # ###
## ##.###################################### ###
## #  . . . . . . . . . . . . . . . . . .  # ###
## #                                       # ###
## ###################################### ## ###
## #  . . . . . . . . . . . . . . . . . .  # ###
## #                                       # ###
## ## ###################################### ###
## #  . . . . . . . . . . . . . . . . . .  # ###
## #                                       # ###
## ###################################### ## ###
## #  . . . . . . . . . . . . . . . . . .  # ###
## #                                       # ###
## ## ###################################### ###
## #  . . . . . . . . . . . . . . . . . .  # ###
## #                                       # ###
## ####################################### # ###
## #                                       # ###
## # $$$$$$$$$$$$$$$$$$$$$$$$$$$$$$$$$$$$$$# ###
## #                                       # ###
## # $$$$$$$$$$$$$$$$$$$$$$$$$$$$$$$$$$$$$$# ###
## #                                     ....###
## ###$#$$$$$$$$$$$$$$$$$$$$$$$$$$$#$#$#$# # ###
## #                                       # ###
#  ######################################### ###
#                                             ##
#  ########################################   ##
################################################
