;LEVEL 12
##################################################
#                                                #
# $######################################## ##$$ #
#                                           #    #
# $###################### ################# ##$$ #
#                         # $ $ $ $ $ $ $ $ #    #
##### ################### #                 ##$$ #
#   # #                   ### $             #    #
# $$# # ################################### ##$$ #
#   # #                                  ## #    #
# $$# # ####$#$#########################    ##$$ #
#   # #      * #.......................#  # #    #
# $$# # #  # $ #.....................  #  # ##$$ #
#   # # #  # . ......                  #  # #    #
# $$# # #  # # #.....................  #  # ##$$ #
#   # # #  # # #.......................#  # #    #
# $$# # #  # # #.......................#  # ##$$ #
#   # # #  # # #########################  # #    #
# $$# # # ##############################  # ##$$ #
#   # # # #   #   ######################  # #    #
# $$# # #                                 # # $$ #
#   # # # ###############################    # # #
# $$# #                                   #    # #
#   # ########################################$# #
# $$  # $ $ $ $ $ $ $ $ $ $ $ $ $ $ $ $ $ $ $  # #
#  #  #                                        # #
#  # ######################################### # #
# $# #                                       $ # #
#  #                                         #   #
# $#  ########################################$# #
#  #                                             #
## #  ######################################## ###
## ### $@$ $ $ $ $ $ $ $ $ $ $ $ $ $ $ $ $ $ $ $ #
##     $ $ $ $ $ $ $ $ $ $ $ $ $ $ $ $ $ $ $ $ $ #
##                                               #
##################################################
