;LEVEL 13
################################################
#                                           ...#
#                                           ...#
#  $ $ $ $ $   $   $ $   $ $ $ $ $   $ $ *...*.#
#  $ $ $ $ $ $ $ $ $ $ $ $ $ $ $ $ $ $ $ $ $ *.#
#  $ $ $ $ $ $ $ $ $ $ $ $ $ $ $ $ $ $ $ $ $ *.#
## ###########################################.#
## # . * #  .$ #  .$ #  .$ #  .$ #  .$ #   ##@.#
## # $   # $   # $   # $   # $   # $   # $  $ ##
## ## ## ## ## ## ## ## ## ## ## ## ## ## #.. ##
## ## ## ## ## ## ## ## ## ## ## ## ## ## #.. ##
## ## ## ## ## ## ## ## ## ## ## ## ## ## #.. ##
## ## ## ## ## ## ## ## ## ## ## ## ## ## #.. ##
## ## ## ## ## ## ## ## ## ## ## ## ## ## #.. ##
## ## ## ## ## ## ## ## ## ## ## ## ## ## #.. ##
## ## ## ## ## ## ## ## ## ## ## ## ## ## #.. ##
## ## ## ## ## ## ## ## ## ## ## ## ## ## #.. ##
## ## ## ## ## ## ## ## ## ## ## ## ## ## #.. ##
## ## ## ## ## ## ## ## ## ## ## ## ## ## #.. ##
## ## ## ## ## ## ## ## ## ## ## ## ## ## #.. ##
## ## ## ## ## ## ## ## ## ## ## ## ## ## #.. ##
## ## ## ## ## ## ## ## ## ## ## ## ## ## #.. ##
## ## ## ## ## ## ## ## ## ## ## ## ## ## #.. ##
## ## ## ## ## ## ## ## ## ## ## ## ## ## #.. ##
## ## ## ## ## ## ## ## ## ## ## ## ## ## #.. ##
## ## ## ## ## ## ## ## ## ## ## ## ## ## #.. ##
## ## ## ## ## ## ## ## ## ## ## ## ## ## #...##
## ## ## ## ## ## ## ## ## ## ## ## ## ## #...##
## ## ## ## ## ## ## ## ## ## ## ## ## ## #...##
## ## ## ## ## ## ## ## ## ## ## ## ## ## #...##
## ## ## ## ## ## ## ## ## ## ## ## ## ## #...##
# $   # $   # $   # $   # $   # $   # $   #...##
#  .$ #  .$ #  .$ #  .$ #  .$ #  .$ #  .$ #...##
# ##########################################.. #
#                                            # #
# ############################################ #
#                                              #
################################################
