;LEVEL 14
################################################
#                                          ....#
#                                          ....#
#  $ $ $ $ $ $ $ $ $ $ $ $ $ $ $ $ $ $ $ *.*.*.#
#  $ $ $ $ $ $ $ $ $ $ $ $ $ $ $ $ $ $ $ $ *.*.#
#  $ $ $ $ $ $ $ $ $ $ $ $ $ $ $ $ $ $ $ $ *.*.#
## ###########################################.#
## #   * #   * #   * #   * #   * #   * #   ##@.#
## # $   # $   # $   # $   # $   # $   # $  $ ##
## ## ## ## ## ## ## ## ## ## ## ## ## ## #.. ##
## ## ## ## ## ## ## ## ## ## ## ## ## ## #.. ##
## ## ## ## ## ## ## ## ## ## ## ## ## ## #.. ##
## ## ## ## ## ## ## ## ## ## ## ## ## ## #.. ##
## ## ## ## ## ## ## ## ## ## ## ## ## ## #.. ##
## ## ## ## ## ## ## ## ## ## ## ## ## ## #.. ##
## ## ## ## ## ## ## ## ## ## ## ## ## ## #.. ##
## ## ## ## ## ## ## ## ## ## ## ## ## ## #.. ##
## ## ## ## ## ## ## ## ## ## ## ## ## ## #.. ##
## ## ## ## ## ## ## ## ## ## ## ## ## ## #.. ##
## ## ## ## ## ## ## ## ## ## ## ## ## ## #.. ##
## ## ## ## ## ## ## ## ## ## ## ## ## ## #.. ##
## ## ## ## ## ## ## ## ## ## ## ## ## ## #.. ##
## ## ## ## ## ## ## ## ## ## ## ## ## ## #.. ##
## ## ## ## ## ## ## ## ## ## ## ## ## ## #.. ##
## ## ## ## ## ## ## ## ## ## ## ## ## ## #.. ##
## ## ## ## ## ## ## ## ## ## ## ## ## ## #.. ##
## ## ## ## ## ## ## ## ## ## ## ## ## ## #...##
## ## ## ## ## ## ## ## ## ## ## ## ## ## #...##
## ## ## ## ## ## ## ## ## ## ## ## ## ## #...##
## ## ## ## ## ## ## ## ## ## ## ## ## ## #...##
## ## ## ## ## ## ## ## ## ## ## ## ## ## #...##
# $   # $   # $   # $   # $   # $   # $   #...##
#   * #   * #   * #   * #   * #   * #   * #...##
# ##########################################.. #
#                                            # #
# ############################################ #
#                                              #
################################################
