         ###############################
         #                             #
########## $#$$$ $ $ $ $ $ $$$$$$$$$$$$#########
#   #   ## $ $ $ $ $ $ $ $ $ $ $ $ $ $ ####    #
# $   #  # $ $ $ $ $ $ $ $ $ $ $ $ $ $    *$## #
## ## ## #                             ## # ## #
## ## ## ###############################  # ## #
## ## ##                                  # ## #
## ## ## $# ######################### ## ## ## #
## ## ##  #                           ## ## ## #
## ## ## $#  ####$################### ## ## ## #
## ## ##  #  #    .........         $ ## ## ## #
## ## ## $#  # #@*................. # ## ## ## #
## ## ##  #  # # .................. # ## ## ## #
## ## ## $#  # # .................. # ## ## ## #
## ## ##  #  # # .................. # ## ## ## #
## ## ## $#  # # .................  # ## ## ## #
## ## ##  #  # #################### $    ## ## #
## ## ## $#  #                      #  # ## ## #
## ## ##  #  ########################### ## ## #
## ## ## $#                               # ## #
## ## ##  #  ###########################    ## #
## ## ## $#################################$## #
## ## ##                                    ## #
## ## ##  ############################### # ## #
## ## ################################### # ## #
## # $                                    #  # #
## #   #################################  #* # #
## #####                                ###. # #
##   $ $ $$$$$$$$$$$$$$$$$$$$$$$$$$$$$$$ *.* # #
## # $                                       # #
#  ######################################## ## #
# $                                            #
#  #############################################
################################################
