                                ############
                                #          #
                                #          #
                                # ###### ###
                                #        #########
########################################.#########
#                                     ...#########
#@$$$$$$$$$#$$$$$$$$$$$$$$$$$#$#########.        #
#                              ##....... ####### #
# $$$$$$$$$$#$$$$$$$$$$$$$$$#$$##....... ......# #
#                              ##....... ......# #
# $$$$$$$$$$$#$$$$$$$$$$$$$#$$$#........ ......# #
#                              #........ ......# #
# $$$$$$$$$$$$#$$$$$$$$$$$#$$$$#........ ......# #
#                              #........ ......# #
# $$$$$$$$$$$$$#$$$$$$$$$#$$$$$#........ ......# #
#                              #...............# #
# $$$$$$$$$$$$$$#$$$$$$$#$$$$$$#...............# #
#                              #...............# #
# $$$$$$$$$$$$$$$#$$$$$#$$$$$$$#...............# #
#                              #...............# #
# $$$$$$$$$$$$$$$$#$$$#$$$$$$$$#...............# #
#                              #...............# #
# $$$$$$$$$$$$$$$$$#$#$$$$$$$$$#...............# #
#                   .          #...............# #
# $$$$$$$$$$$$$$$$$$#$$$$$$$$$$#...............# #
#                              #...............# #
# $$$$$$$$$$$$$$$$$#$$$$$$$$$$$#...............# #
#                              #...............# #
# $$$$$$$$$$$$$$$$#$$$$$$$$$$$##...............# #
#                              #...............# #
# $$$$$$$$$$$$$$$#$$$$$$$$$$$$##...............# #
#                              #...............# #
# $$$$$$$$$$$$$$#$$$$$$$$$$$$$###..............# #
#                              ##...... . .....# #
# ##$###########$$$$$$$$$$$######...... . ###### #
#  # # # # # # # $ $ $ $ $ # # ################# #
#                                                #
##################################################
