###############################################
#      ### #@# ##                             #
# ####.### #      # # # # # # # # # # # # #$$ #
#            # ## # # # # # # # # # # # # #   #
######.### # # ##   $ $ $ $ $ $ $ $ $ $ $ $   #
#   .   .# # # ##$########################## ##
#   .   .# # # # $   $   $   $   $            #
#   .   .# # # #   #   #   #   #   ######### ##
#   .   .# # # ######################      # ##
#   .   .# # #                   #### $$ $ # ##
#   .   .# # # $$$$$$$$$$$$$$$$$$###   $ $ # ##
#   .   .# # # $ $ $ $ $ $ $ $ $     # ##### ##
#   .   .# # #                   # # $        #
#   .   .# # ##################### ### #####  #
#   .   .# #                     # # # #   # ##
#   .   .# # ##############*$$$$$# # # #   # ##
#   .   .# #                     # # # ##$ # ##
#   .   .# # ###############$$$$$# # $    ## ##
#   .   .# #                     # # ## #  # ##
#   .   .# # ##############*$$$$$# #  # $  # ##
#   .   .# #                     # # ## ## # ##
#   .   .# # ###############$$$$$# #  # #  # ##
#   .   .# #                     # ## $ $  # ##
#   .   .# # ##############*$$$$$# ## ## # # ##
#   .   .# #                     # #    $$ # ##
#   .   .# #####################$# # # # ### ##
#   .   .# $ $ $ $ $ $ $ $ #    $  # #  $  # ##
#   .   .#                   ##    # #$### # ##
#   .   .###### ###########$########    $  # ##
#..........#### $   $ $ $ $         ### ## # ##
#..........#   #$#           ######     $  . ##
#..........# $   # ###########    # ###### # ##
#..........## ##                  #     $  # ##
#..........## ##################### ######## ##
#..........#  $ $ $ $ $ $ $ $ $ $ $ $ $    #  #
#..........#                             #    #
###############################################
