;LEVEL 18
##################################################
#                                                #
# $$ $ $ $ $ $ $ $ $ $ $ $ $ $ $ # # # # # # # # #
#  ############################################# #
# $#  #                                        # #
#  #     #                                       #
# $#$ #$ # # ################################# # #
#  #  #  # #     ..   ...   ...   ...   ...  # # #
# $#$ #$ # #       . .   . .   . .   . .   . # # #
#  #  #  # # ......   ...   ...   ...   ...  # # #
# $#$ #$ # #       ...   ...   ...   ...   . # # #
#  #  #  # # ....  ...   ... . ... . ......*.  # #
# $#$ #$ # #       ...   ...   ...   ...   . # # #
#  #  #  # # ......   ...   ...   ...   ...  # # #
# $#$ #$ # #       . .   . .   . .   . .   . # # #
#  #  #  # #     ..   ...   ...   ...   ...  # # #
# $#$ #$ # # ############################### # # #
#  #  #  # #         #    ##  #              # # #
# $#$ #$ # # #####   ## #  #    # # ######## # # #
#  #  #  # #         ## ## #  #              # # #
# $#$ #$ # # ### # ###     ## # # # ######## # # #
#  #  #  # #   # #     # #    #              # # #
# $#$ #$ # # ### # # # #   #  # ## ######### # # #
#  #  #  # #     # # # # # #  #  # # $ $ $ $ # # #
# $#$ #$ # # # #     # #   #  ## # #  $ $ $  # # #
#  #  #  # # #  ## #     # #     # # $ $ $ $ # # #
# $#$ #$ # $     # # # #     #       #       # # #
#  #  #  # ###                 ###           # # #
# $#$ #$ # ################################### # #
#  #  #  #                                       #
# $#$ #$ # $ $ $ $ $ $ $ $ $ $ $ $ $ $ $ $ $ $ $ #
#  #  #  # #$################################### #
# $#$ #$ # $                                     #
#  #  #  #   # $ $ $ $ $ $ $ $ $ $ $ $ $ $ $ $  ##
# $#$ #  # ####################################$##
#     #  @ $ $ $ $ $ $ $ $ $ $ $ $ $ $ $ $ $ $ $ #
#       ##                                       #
##################################################
