;LEVEL 19
##################################################
#                                                #
# # # # # # $ $ $ $ $ $$@$ $ $ $ # # $ $ $ $ $ $ #
# ###   # # $ $ $ $ $ $  $ $ $ $ $ $ $ $ $ $ $ $ #
# # # # # # # $ $ $ $ $ $$ $ # # $ $ $ $ $ $ $ $ #
#     # # # # # # $ $ $  $ $ $ $ # # # # # # # # #
######################## ####################### #
#                      # #                       #
# $ $ $ $ $ $ $ $ $  $ # # ####################$ #
# ###$############$#$### #                       #
#    $                     # # ################$ #
# $$$#$            # ####### # #                 #
#    $  $#$$$$$$$#$#         # # $$$    .  $  #$ #
# $$$#             # ## # ## # ### ####### #  #  #
#    #  $$#$$$$$#$$#  # # #  # ###  $ $  # #  #$ #
# $$$#             #  ###### # ###    ## # #  #  #
#    #  $$$#$$$#$$$#  # # #  # ###  #   .# #  #$ #
# $$$#             # ## # ## # ###  #  # # #  #  #
#    #  $$$$#$#$$$$#         # ###  #  # # #  #$ #
# $$$#             # ########  ###  #  # # #  #  #
#    #  $$$$$#$$$###        #  ###  #  #.# #  #$ #
# $$$#             # #### $ #  ###  #  # # #  #  #
#    #           #       $# #$ ###  #  # # #  #$ #
#  $ #################### $ #  ###  #  # # #  #  #
# $#$                       #  ###  #  # # #  #$ #
#  $ ########################  ###  #  # # #  #  #
#                              ###  #  # # #  #$ #
#                              #    #  # # #  #  #
############################## # #  #$ #.# #  #$ #
#                            #   # ##  # #       #
# . . . . . . . .            ####### $ #.# ##### #
# . . . . . . . .                  #   #.#       #
#................                  #####.##### $ #
#............................................    #
#................ .   .   .   .   .   . # . .# $ #
#............................................#$$ #
#................                            #   #
##################################################
