######################
#                    #
# $  $ $ $ $ $ $ $ $ #
# $$$$$###########################################
#                                                #
# $$$$$#  $ $ $ $ $ ########################## # #
#      #  $ $ $ $ $ #   $  $  $  $  $  $  $    # #
# $$$$$#  ### # # ## #                       $   #
#      #  #        #  # ##################### ## #
# $$$$$#  #### ## ##$ #   #                 # #  #
#      #     # #  #   # #   ..............  # #  #
# $$$$$#  $$$# #  #   # #.################ ## #  #
#      #     # #  # $ # #.               #  #$#  #
# $$$$$#  $$$# #  #   # #.############## #  # #  #
#      #     # #  #   # #.#.......     # #  # #  #
# $$$$$#  $$$# #  # $ # #.#.......     # #. # #  #
#      #     # #  #   # #.#.......     # #. #    #
# $$$$$#  $$$# #  #   # #.#.......     # #. #$#  #
#      #     # #  # $ # #.#.......     # #. # #  #
# $$$$$#  $$$# #  #   # #.#.......     # #. # #  #
#      #     # #  #   # #.#.......     # #. # #  #
#@$$$$$#  $$$# # .# $ # ...............# #. #    #
#      #     # #  #   # #.#............# #. #$#  #
# $$$$$#  $$$# #  #   # #.#............# #. # #  #
#      #     # #  # $ # #.#............# #. # #  #
# $$$$$#  $$$# #  #   # #.#............# #. # #  #
#      #     # #  #   # #.#............# #. #    #
# $$$$$#  $$$# #  # $ # #.#............# #  #$#  #
#      #     # #  #   # #.#............# #  # #  #
# $$$$$#  $$$# #  #   # #.################  # #  #
#      #     # #  # # # #                #  # #  #
# $$$$$#  $$$# #  # $                       #    #
#      #     # #  ## # ###################$##$#  #
# $$$$$#  #    #     #                   # ## #  #
#      #  #### ##### #  $$ $$ $$ $$ $$ $$   # #  #
# $$$$$#           # # $  $  $  $  $  $  $$ # #  #
#      #  ###  # # # # $  $  $  $  $  $  $  $ $  #
# $$$$$######### # # ######################## ## #
#                #                               #
#      #       #                                 #
##################################################
