;LEVEL 5
 #######
 #  @  #
 #*$*$*#
 # .$. #
##. # .##
#  *$*  #
#   *   #
#  ###  #
#### ####
