;LEVEL 6
##### ####
#   ###  #
# $     @#
##$*****$##
# $.....$ #
#   #     #
########  #
       ####
