;LEVEL 6
##### ####
#   ###  #
#        #
## ***** ##
#  @$.    #
#   #     #
########  #
       ####
