;LEVEL 9
  ####
  # @##
  #$$ #
### * ###
#  .*.$ #
#  .*.  #
# #.*.# #
# $$$   #
###   ###
  ##  #
   ####
