#############
#    *     @#
#.   *  $   #
#    *      #
#############